M       M         A                                       
M     P M        BBM                           S          
M  BBBBBM          M                         BBBBB        
M       M   S      M                                      
M   S   M          M               S           M          
MBBBBB  M          M                           M          
M       M     BJBB M                    BBBBB  M     S    
M   S   M          MC                          M  BJBBB   
M  BBBBBM          MCC             C           M          
M       M          MCCC     S     CCC          M          
                   MCCCC         CCCCC         M          
                   MCCCCC       CCCCCCC        M  S       
GGGGGGGGGGGJGGGGGGGGGGGGGG     GGGGGGGGGGGGGGGGGGGGGGGGGJG
GGGGGGGGGGGGGGGGGGGGGGGGGGG   GGGGGGGGGGGGGGGGGGGGGGGGGGGG