                                       M        
                                       M        
                                       M        
     S        S                        M        
     BBB    BBBB                                
         MM                                     
                                       S        
  P          S                                  
  B          BB      C  C          CC  C        
                    CC  CC        CCC  CC       
                   CCC  CCC      CCCC  CCC      
                  CCCC SCCCC    CCCCC  CCCC     
GGGGGGGGGGGGGGGGGGGGGGGGGGGGGGGGGGGGG  GGGGGGGGG
GGGGGGGGGGGGGGGGGGGGGGGGGGGGGGGGGGGGG  GGGGGGGGG