                         MMM  S MMMMM                      M     M
      CCCCCCC      S                               S       M  S  M
M   MMBBBBBBBBBBBBBBBBB               BBBBBBBBBBBBBBBBB    M     M
M   MMMM     MM       CCCCCCCCJCCCCCCCC               C    M     M
M   MM    S                               BBBBBBB     C           
M   MM            CCCCC  C              S M           C           
M                CCCCCC  CC    MMMMMMMMMMMM       S   C           
M    A    M     CCCCCCCS CCC                          C           
BJBBBBBBBBBBBBBBBBBBBBBBBBBBBBBBBBBBBBBBBBBBBBBBBBBBBBBBJBBBBBJ   
                   S       MMMMMMMMMMM   CCCCCCCCCCCCCCCCCCCCCC   
                                                              A   
 P        S                     S        CCCCCCCCCCCCCCCCCCCCCC   
GGGGGGGGGGGGGGGGGGGGGGGGGGGGGGGGGGGGGGGGGGGGGGGGGGGGGGGGGGGGGGGGGG
GGGGGGGGGGGGGGGGGGGGGGGGGGGGGGGGGGGGGGGGGGGGGGGGGGGGGGGGGGGGGGGGGG