             S                                     
     MMM   BBBB                                    
                                                   
                  S          S                     
                BBBBBBB   BBBBBB                   
                                                   
                                                   
   P  BBJBB     S                       C          
   BBB               C      C      BB   C   C      
                    CC      CC          C   CC  S  
                   CCC      CCC         C   CCC    
                  CCCC      CCCC        C   CCCC   
GGGGGGGGGGGGGGGGGGGGGG      GGGGGGGGGGGGG   GGGGGGG
GGGGGGGGGGGGGGGGGGGGGG      GGGGGGGGGGGGG   GGGGGGG