    SA                                                                                                                                      AS 
    CCCCCCCCCCCCCCCCCCCCCCCCCCCCCCCCCCCCCCCCCCCCCCCCCCCCCCCCCCCCCCCCCCCCCCCCCCCCCCCCCCCCCCCCCCCCCCCCCCCCCCCCCCCCCCCCCCCCCCCCCCCCCCCCCCCCCCCCCC 
                                                                      CPCS  C              SC   C     C      SC   CSC+---------+C    SC+------
             S                      S                      C          C CCC C CCCCCCCCCCCCCCCCC C C C C CCCCCCC C C C|CCCCCCCCC|C CCCCC|CCCCCCC
                    S                                      CC         C C   C C+-------A-----     C C   C       C   C|C   C   C|C C+---+C   CSC
   J                                        S         CCCCCCCC        C C CCC C|CCCCCCC CCCCC|CCCCC CCCCC CCCCCCCCCCC|C C C C CSC C|C CCC C C C
         S                                                 CCCCS      C C     C+---+CSC     C|C              +---S---A  C   C C|C C|C C   CSC C
                             S                             CCCCC      C CCC CCCCCCC|C CCCCC C|C CCCCCCCCC CCC|CCCCCCCCC CCCCC C|C C|C C CCCCC C
                                                           CCCCCC     C C   C      |C       C|C        SC   C|C         CS  C C+---+C       C C
    J                                                      CCCCCCC    C C CCC CCCCC|C CCCCCCC|CCCCCCCCCCCCCCC|C CCCCCCC CCC C CJCJCCCCC CCC C C
        J         J               J                        CCCCCCCC   C C     C+---+C C     C+-----S---------+C CSC       C   CS    C    SC C C
             J         A     J          J          J       CCCCCCCCC    +CCCCCC|CCCCC C CCC CJCCCCCCCCCCCCCCCCC C CCCCCJC CCCjCCCCC CCCCCCC C C
                       J                     J             GGGGGGGGGGGGG+------+CS      C      S                C                 C           C
                                                           GGGGGGGGGGGGGGGGGGGGGGGGGGJGGGGGGGGGGGGGGGGGGGGGGGGGGGGGGGGGGGGGGGGGGGGGGGGGGGGGGGJG