   C                                
 P C             S                  
   C      BBBBBBBBBBBBBBB           
   C                             S  
   CS     M  S  M  S  M   C   BBBBBB
   CCCCC                  C         
   C                      C      S  
   C                      CCCCCCCCCC
   C                               M
   C                              SM
          S     S     S            M
                                   M
CCCCCJJJJJJJJJJJJJJJJJJJJJJJJJJJJJJJ
GGGGGGGGGGGGGGGGGGGGGGGGGGGGGGGGGGGG