                                                                                                              
         C           C                       C                C      C                        C               
         C           C                       C                C      C                        C               
         C           C                       C                C      C                        C               
         C    CCC    CCCCC     CCCCC         C   CCCCCC       CC     C   CCC       CCC  C  CCCCCCC    CCC     
       J C   C   C   C    C    C    C        C  C         A   C C    C  C   C     C   C C     C      C   C    
         C  C     C  C     C   C     C    J  C C          J   C  C   C C     C   C     CC     C     C     CA  
         C C       J C      C  C      C      C  C             C   C  C C  M   C C       C     C    C       C  
  P      C C   M   C C       J C       C     C   CCCCCC       C    J C C     C  C   M   C     C    C   M   C  
  C      C C       C C   M   C C   M   C     C         C      C     CC CCCCCC   C       C     C    C       C  
  C     J   C     C  C       C C       C     C          C     C      C  C        C     CC     C     C     C   
   C   C     C   C   C       C C       C     C         C      C      C   C        C   C C     C      C   C    
    CCC       CCC    C       C C       C     C   CCCCCC       C      C    CCCCC    CCC   C    C       CCC     
                                                                                                             S