                                  CCCCCMMMM                                   CCCCCCCCCCCCCCCCCCC                         
              C             BBBB  CCCCC                                       CC  S            CC    CCCC CCCC            
             CC          BBB      CCCCC         CCCCCCCCCC                     CC             CC    C         C           
            CCC    BBBBBB         CCCCC        CCM   S                         CCCCCCCCC    CC     C           C     S   
           CCCC                   CCCCC       CCM   BBBB                        A      CCC  CC    C             C         
          CCCCC                   CCCCC      CC      M        S            CCCCCCCC C    C CC     C             C         
    S    CCCCCC         S           SA                               CC    CCMMMMMC CC            C             C         
        CCCCCCC   JCCCCCCCC       CCCCCCCCCCC                       CCC       MMMMC CCC           C  S       S  C         
       CCC                        CCCCC     C                      CCCC    C  MMMMC CCCCCC CCC    C             C         
      CCCC    C                   CCCCC  S  C                     CCCCC    C     SC C      CCCC   C             C         
     CCCCC    C                   CCCCC     CCCCCCJCCCCCCCCCCCCCCCCCCCCCCCCCCCCCCCC C      CCCCCCJC             C         
 P  CCCCCCS   C                   CCCCC                                             CS     CCCCCCCC                       
GGGGGGGGGGGG  GGJGGGGGGGGGGGGGGGGGGGGGGGGGGGGGGGGGGGGGGGGGGGGGGGGGGGGGGGGGGGGGGGGGGJGGGGGGJGGGGGGGGGGGGG   GGGGGGGGGGJGGGG
GGGGGGGGGGGGG GGGGGGGGGGGGGGGGGGGGGGGGGGGGGGGGGGGGGGGGGGGGGGGGGGGGGGGGGGGGGGGGGGGGGGGGGGGGGGGGGGGGGGGGGG   GGGGGGGGGGGGGGG